..........
.++++++.+.
......+...
.+.+..+++.
...+..+...
...+..+...
...+......
.+.+++++..
.+........
......++..
